{
    "layout": [
        "████████≡hallway≡≡████████",
        "██░░░░░░░░░░░░░░░░░░▒▒c▒██",
        "██░░░░░░░░░░░░░░░░░░▒▒h▒██",
        " ║░░░░░░░░░░░░░░░░░░▒▒e▒██",
        " g░░░░░░░░░░░░░░░░░░▒▒s▒██",
        " a░░░░░░░░░░░░░░░░░░▒▒t▒██",
        " r░░░░░░░░░░░░░░░░░░░░░░██",
        " d░░░░░░░░░░░░░░░░░░░░░░██",
        " e░░░░░░░░░░░░░░░░░░░░░░██",
        " n░░░░░░░░░░░░░░░░░░░░░░██",
        " ║░░░░░░░░░░░░░░░░░░░░░░██",
        "██░░░░░░░░░░░░░░░░░░░░░░██",
        "██░░░░░░░░░░░░░░░░░░░░░░██",
        "██████████████████████████"
    ],
    "containers": {
        "chest": {
            "items":{
                "0001":1,
                "0002":0.5
            },
            "searched":false
        }
    }
}